A ## #######################################################
#      # #   ## #######  #   #     #    ##    ## # ## ######
# ###       #   # ## #  ###      #     #  #  #  #     # ####
# ### #####   # #    #   # #       ## # #    ##     #    ###
# ### ### # #     ####      ##  #  #  ## ###    # # #  #####
# ### ### ### ##         ## ## ##   #         # # # #  #####
# #   ###        ###  #  #       ##    #  ## ## #   ## #####
    # # # # ####  ### ## #  ##  ##  #  # # # #  # ###  #####
# # # #   #   # #     #   # ####   #  #  ##     #   #      #
########################################################## B